11111111111111111111
1000C0000000000C0001
1CCCCCCCCP00000000C1
100000000C00000000E1
11111111111111111111