1111111111
1C11P10111
10C0C00001
1000000001
11111111E1
1111111111