11111111111111111111
1000C0000000000C0001
11011111111111111001
11011110111111111001
1CC111111P0000000001
100000000C00000000E1
11111111111111111111