1111111111111111111
1CC1001C1C011111111
11P0011E11010011111
10C100000C010011111
10C100000C010011111
10C100000C010011111
1111111111111111111
1111111111111111111
1111111111111111111