111111111111111111111111111111
1000000P0000000111111111111111
100000000000E00111111111111111
1CCCCCCCCCCCCCC111111111111111
111111111111111111111111111111
111111111111111111111111111111
111111111111111111111111111111
111111111111111111111111111111
111111111111111111111111111111
111111111111111111111111111111
111111111111111111111111111111
111111111111111111111111111111
111111111111111111111111111111