111111111111111111111
1C0000CCCC000000000C1
10001010000E0001C0011
1P0011100000000CCCC01
111111111111111111111
