1111111111111
10010EC0000C1

1C00011111001
1P00110000001
1111111111111